111111111111111111111111111111111111111111111111
111111111111111111111111111111111111111111111111
111111111111111111111111111111111111111111111111
111111111111111111111111111111111111111111111111
111111111111111111111111111111111111111111111111
111111111111111111111111111111111111111111111111
111111111111111111111111111111111111111111111111
111111111111111111111111111111111111111111111111
111111111111111111111111111111111111111111111111
111111111111111111111111111111111111111111111111
111111111111111111111011111000000000000111111111
111111111111111111111011111000011111100111111111
111111111111000000011011111000011111100111111111
111111111111000000011011111001111111100111111111
111111110000000000011011111001111111100111111111
111111110000000000000000000330011001100111111111
111111110000000000000000000330011001100111111111
111111110011000000000000000330000000000111111111
111111110011000000000000000330000000000111111111
000000000000000000000000000330000000000111111111
000000000000000000000000000330000000000111111111
110000000000000000011111111000000000000111111111
110000000000000000011111111000000000000111111111
111100000000111111111111111000000000000111111111
111100000000111111111111111000000000000111111111
111100000011111111111111111000000000000000000000
111100000011111111111111111000000000000000000000
111100000000000000011111111000000000000000000000
111100000000000000011111111000000000000000000000