1111111111111111111111111111111111111111111111111111111111111111111111111111111111111111111111111111
1111111111111111111111111111111111111111111111111111111111111111111111111111111111111111111111111111
1111111111111111111111111111111111111111111111111111111111111111111111111111111111111111111111111111
1111111111111111111111111000111111111111111111111111111111111111111111111111111111111111111111111111
1111111111111111111111111000111111111111111111111111111111111111111111111111111111111111111111111111
1111111111111111111111111000111111111111111111111111111111111111111111111111111111111111111111111111
1111111111111111111111111000111111111111111111111111111111111111111111111111111111111111111111111111
1111111111111111111111111000000000000000001111111111111111111111111111111111111111111111111111111111
1111111111111111111111111000000000000000001111111111111111111111111111111111111111111111111111111111
1111111111111111111111111000111111111111111111111111111111111111111111111111111111111111111111111111
1111111111111111111111111000111111111111111111111111111111111111111111111111111333333333331111111111
1111111111111100111111111000111111111111111111111111111111111111111111111111111333311111331111111111
1111111111111100111100000000000001111111111111111111111111111110000000111111111333311111331111111111
1111111000000000000000000000000001111001111111111111111111111110000000111111111331111111331111111111
1111111000000000000000111111111001111001111111111111111111111110000000111111111001111111331111111111
1111111111111111111100111111111000000000000000000001111111133330000000333333333333311001331111111111
1111111111111111111100111111111000000000000000000001111111133330000000333333333333311001331111111111
1111111111111111111100111111111001111111111111111001111111133110000000333333333333303333331111111111
1111111111111111111100111111111001111111111111111001111111133110000000333333333333303333331111111111
1111111111111111111100111111111001111111111111111000000000000000000000333333333333303333331111111111
1111111111111111111100111111111001111111111111111000000000000000000000333333333333303333331111111111
1111111111111111111100000000000001111111111111111110000000000000000000111111111000003333331111111111
1111111111111111111100000000000001111111111111111110000000000000000000111111111333333333331111111111
1111111111111111111111111000111111111111111111111113333000333311111111111111111333333333331111111111
1111111111110111111111111000111111111110011111111113333000333311111111111111111333333333331111111111
1111111111110111111111111000111111111110011111111113333000331111111111111111111333333333333333333333
1111111110000000000000000000000000000000000000011113333000331111111111111111111333333333333333333333
1111111110000000000000000000000000000000000000011113333000000000000000111111111333333333333333333333
1111111111111111111111111111111111111111111111111113333000000000000000111111111333333333333333333333